111111111111111.1111111111111111
1*............................*1
1.1.11.111.111.11.111.111.11.1.1
1.1.11...1...1....1...1...11.1.1
1.1....1...1...B1...1...1....1.1
1.1111.11.111 1111 111.11.1111.1
1.......1...1G GG G1...1.......1
1.111.1.1.1.1G GG G1.1.1.1.111.1
1...1.1.1.1.1 1111 1.1.1.1.1...1
111.1.1.1.1..........1.1.1.1.111
............11111111............
11111.111.1..........1.111.11111
1.........1.1111.111.1.........1
1.1.1.1.111...1..1...111.1.1.1.1
1.1.1.1.1...1.1.11.1...1.1.1.1.1
1.1.1.1.1.1...1..1...1.1.1.1.1.1
1.1...1.1.1.1.11.1.1.1.1.1...1.1
1.1.1.1.1.1...1..1...1.1.1.1.1.1
1.1.1.1.1.111.1.11.111.1.1.1.1.1
1*...........................P*1
111111111111111.1111111111111111